##LEVEL1######################################################################
#                     #                                                      #
#                   #                                                        #
#                                                                   #        #
#                                                                            #
#                                                                            #
#                                                                            #
#                                                                            #
#                                                                            #
#                                                  #                         #
#                                                                           ##
#                                                                            #
#                                                                            #
#                                                                            #
#                                                                            #
#                                                                            #
#                                                                          # #
#                                                          #                 #
#                                                                  #         #
#                                 #                                          #
#                                                   #                        #
#                                                                            #
##                                                                           #
#                                                                           ##
#                                                                            #
#                                                                            #
#                                                                            #
#                                                                            #
#                                                                            #
#                                                                            #
#                                  #                                         #
#                    #                      #               #               @#
##############################################################################
