##LEVEL2######################################################################
#      #                                                      #              #
#                                                                            #
#                                                                            #
#                        #                                                   #
#                                                     #                      #
#                                                                            #
#                                                                            #
#                #                                                           #
#     #                                                                      #
#                                            #                               #
#                                                                  #         #
#                                                                            #
#                                                                            #
#                                                                            #
#               #                                                  #         #
#                                                                            #
#                                                                            #
#                                                                   #        #
#                                                    #                       #
#                             #                                              #
##                                                                          ##
#                                                                            #
#                                                   #                        #
#                              #                                             #
#                                                  #                         #
#                                                                            #
#                                                 #                          #
#                                                                           ##
#                                                  #                         #
#                       #                                           #        #
#                                           #                   #  #        @#
##############################################################################
