##LEVEL3######################################################################
#       #                                                                    #
#                                                                            #
#                                                                            #
#                                            #                               #
#                                                  #                         #
#      #                                                                     #
#                         #                                                  #
#                                             #                              #
#                                                          #                 #
#                                                                           ##
#             #                                #                             #
#                          #                                #                #
#                  #                                                         #
##                                            #                              #
#                                         #                                  #
#                                                                #           #
#            #                                                     #         #
#                             #              #                               #
#                                                 #                         ##
#                                                                            #
#                                                                      #     #
#              #                                                  #          #
#                            #                          #                    #
##                                              #                            #
#                                                                           ##
#                                                                 #          #
#                                        #              #              #   ###
#                 #               #                                   #      #
#                             #                          #                   #
#                                                           #                #
#             #                              #                       #      @#
##############################################################################
