##LEVEL4######################################################################
#    #                                                                       #
#                        #                                                   #
#                                    #                                       #
#                                                        #                   #
#                          #                                                 #
#              #                                                     #       #
#       #                                   #                                #
#                                                           #                #
#                                                 #                          #
#                 #                                                          #
#                                   #                                        #
#                                                                #           #
#                                                    #                       #
#                           #               #                      #         #
#   #                                                                        #
#                  #                              #            #             #
#                                            #                          #    #
#                                                               #            #
#                                                #                  #        #
##                                          #                                #
#                                                         #                # #
#                   #                                                  #     #
#                                  #                                 #       #
#      #                                                   #                 #
#                              #                                      #      #
#                                               #   #                     #  #
#            #                                        #               # ######
#                               #              #                        #   ##
#                                                            #         #     #
#             #                    #                                     #   #
#                                               #                     #     @#
##############################################################################
