##LEVEL5######################################################################
#  #                                                   #                     #
#      #       #       #          #                             #            #
# #                                         #                                #
#  #                #        #     #                      #        #         #
#     #       #                         #       #     #        #             #
#        #                  #              #                                 #
#   #                #            #                 #                  #     #
# #            #                         #     #                  #          #
#       #                  #                               #        #        #
#         #           #                 #          #                      #  #
#  #            #                #                                    #      #
#        #             #       #######                                       #
#            #            #    #@    #                 #      #              #
#   #             #            #                                             #
#           #  #     #         #######                                     # #
#    #                  #                  #                             #   #
#          #              #                       #                          #
#     #        #      #                #                       #             #
#         #        #           #                #   #                       ##
#      #                 #       #                 #                      #  #
#  #     #                              #      #                             #
#       #       #       #            #               #                       #
#          #  #     #           #            #    #                          #
#   #                                     #                    #             #
#         #                 #     #                #                         #
# #          #         #              #        #      #                      #
#    #           #       #                  #                              # #
#                          #            #        #                           #
#        #                     #              #     #         ##             #
#  #          #           #        #                                 #       #
#       #                     #                   #            #             #
##############################################################################
